1111111111111111111111111
1110000000000000000000111
1110000000000000000000111
1000000000000000000000001
1000000000000000000000001
1000000000000000000000001
1000000000000000000000001
1000000000011100000000001
1000000001111111000000001
1000000001111111000000001
1000000001111111000000001
1000000000011100000000001
1000000000000000000000001
1000000000000000000000001
1000000000000000000000001
1000000000000000000000001
1000000000000000000000001
1110000000000000000000111
1110000000000000000000111
1111111111111111111111111