1111111111111111111111111
1000000000000000000000001
1000000000000000000000001
1000000000000000000000001
1000000111111111110000001
1000000100001000010000001
1000000100001000010000001
1000000000000000000000001
1000000000000000000000001
1000000000000000000000001
1000000000000000000000001
1000000000000000000000001
1000000100001000010000001
1000000100001000010000001
1000000111111111110000001
1000000000000000000000001
1000000000000000000000001
1000000000000000000000001
1000000000000000000000001
1111111111111111111111111