1111111111111111111111111
1000000000000000000000001
1000001000000000010000001
1000000100000000100000001
1000000010000001000000001
1000000001000010000000001
1000000000111100000000001
1000000000000000000000001
1000000000000000000000001
1000000000000000000000001
1000000000000000000000001
1000000000000000000000001
1000000000000000000000001
1000000000111100000000001
1000000001000010000000001
1000000010000001000000001
1000000100000000100000001
1000001000000000010000001
1000000000000000000000001
1111111111111111111111111